1 1
3333 4444 4444 4444 4444 4444 4444 4444 4444 4444 4444 4444 4444 4444 4444 4444 4444 4444 4444 4444 4444 4444 4444 4444 4444 1111
0020 0000 0000 0000 0000 0000 0000 0000 0000 0000 0000 0000 0000 0000 0000 0000 0000 0000 0000 0000 0000 0000 0000 0000 0000 1111
3333 0000 0000 0000 0000 0000 0000 0000 0000 0000 0000 0000 0000 0000 0000 0000 0000 0000 0000 0000 0000 0000 0000 0000 0000 1111
3333 0000 0000 0000 0000 0000 0000 0000 0000 0000 0000 0000 0000 0000 0000 0000 0000 0000 0000 0000 0000 0000 0000 0000 0000 1111
3333 0000 0000 0000 0000 0000 1423 1423 0000 1423 1423 0000 0000 0000 0000 0000 0000 0000 1423 1423 0000 0000 0000 0000 0000 1111
3333 0000 0000 0000 0000 0000 1423 0000 0000 0000 1423 0000 0000 0000 0000 0000 0000 1423 0000 0000 1423 0000 0000 0000 0000 1111
3333 0000 1423 1423 1423 1423 1423 0000 0000 0000 1423 0000 0000 0000 0000 0000 1423 0000 0000 0000 0000 1423 0000 0000 0000 1111
3333 0000 1423 0000 0000 0000 1423 0000 0000 0000 1423 0000 0000 0000 0000 1423 0000 0000 0000 0000 0000 0000 1423 0000 0000 1111
3333 0000 1423 0000 0000 0000 1423 1423 1423 1423 1423 0000 0000 0000 0000 0000 0000 0000 6666 5555 0000 0000 0000 0000 0000 1111
3333 0000 1423 0000 0000 0000 1423 0000 0000 0000 0000 0000 0000 0000 0000 1423 0000 0000 0000 0000 0000 0000 1423 0000 0000 1111
3333 0000 1423 1423 0000 1423 1423 0000 0000 0000 0000 0000 0000 0000 0000 0000 1423 0000 0000 0000 0000 1423 0000 0000 0000 1111
3333 0000 0000 0000 0000 0000 0000 0000 0000 0000 0000 0000 0000 0000 0000 0000 0000 1423 0000 0000 1423 0000 0000 0000 0000 1111
3333 0000 0000 0000 0000 0000 0000 0000 0000 0000 0000 0000 0000 0000 0000 0000 0000 0000 1423 1423 0000 0000 0000 0000 0000 1111
3333 0000 0000 0000 0000 0000 0000 0000 0000 0000 0000 0000 0000 0000 0000 0000 0000 0000 0000 0000 0000 0000 0000 0000 0000 1111
3333 0000 0000 0000 0000 0000 0000 0000 0000 0000 0000 0000 0000 0000 0000 0000 0000 0000 0000 0000 0000 0000 0000 0000 0000 1111
3333 0000 0000 0000 0000 0000 0000 0000 0000 0000 0000 0000 0000 0000 0000 0000 0000 0000 0000 0000 0000 0000 0000 0000 0000 1111
3333 0000 0000 0000 0000 0000 0000 0000 1423 1423 1423 0000 1423 1423 1423 1423 0000 0000 0000 0000 0000 0000 0000 0000 0000 1111
3333 0000 0000 0000 0000 0000 0000 0000 0000 0000 1423 0000 0000 0000 0000 1423 0000 0000 0000 0000 0000 0000 0000 0000 0000 1111
3333 0000 0000 0000 0000 0000 0000 0000 1423 0000 1423 0000 0000 0000 0000 1423 0000 0000 0000 0000 0000 0000 0000 0000 0000 1111
3333 0000 0000 0000 0000 0000 0000 0000 1423 0000 1423 0000 0000 0000 0000 1423 0000 0000 0000 0000 0000 0000 0000 0000 0000 1111
3333 0000 0000 0000 0000 0000 0000 0000 1423 0000 0000 0000 0000 0000 0000 1423 0000 0000 0000 0000 0000 0000 0000 0000 0000 1111
3333 0000 0000 0000 0000 0000 0000 0000 1423 0000 1423 1423 1423 1423 1423 1423 0000 0000 0000 0000 0000 0000 0000 0000 0000 1111
3333 0000 0000 0000 0000 0000 0000 0000 1423 0000 0000 0000 0000 0000 0000 0000 0000 0000 0000 0000 0000 0000 0000 0000 0000 1111
3333 0000 0000 0000 0000 0000 0000 0000 1423 1423 1423 1423 1423 1423 1423 1423 0000 0000 0000 0000 0000 0000 0000 0000 0000 1111
3333 0000 0000 0000 0000 0000 0000 0000 0000 0000 0000 0000 0000 0000 0000 0000 0000 0000 0000 0000 0000 0000 0000 0000 0000 1111
3333 2222 2222 2222 2222 2222 2222 2222 2222 2222 2222 2222 2222 2222 2222 2222 2222 2222 2222 2222 2222 2222 2222 2222 2222 1111